9
9
underTile
field
001111100
001111100
011111110
011111110
011111110
011111110
011111110
001111100
001111100
tiles
000000000
000222000
000222000
002222200
002222200
002222200
000222000
000222000
000000000
colors
AAAA2AAAA
AAA011AAA
AAA001AAA
AA2110AAA
AA2100AAA
AAA011AAA
AAA001AAA
AAAAAAAAA
AAAAAAAAA
underTiles
3
3 1 3 6
2 3 1 2
6 3 1 2
